{
  "id": "demo",
  "name": "Demo Stage",
  "size": {
    "width": 640,
    "height": 480,
    "tileSize": 16
  },
  "tileset": "tileset.png",
  "background": {
    "color": "#1a1a2e",
    "image": "bg_cave.png",
    "parallax": 0.5
  },
  "connections": {
    "right": null,
    "left": null,
    "up": null,
    "down": null
  },
  "playerSpawn": {"x": 48, "y": 400},
  "layers": {
    "collision": [
      "########################################",
      "#......................................#",
      "#......................................#",
      "#......................................#",
      "#......................................#",
      "#..........#####.......................#",
      "#......................................#",
      "#......................................#",
      "#...####...............................#",
      "#......................................#",
      "#..............#####...................#",
      "#......................................#",
      "#......................................#",
      "#.....#####............................#",
      "#......................................#",
      "#................SSS...................#",
      "#..####................................#",
      "#......................................#",
      "#....................#####.............#",
      "#......................................#",
      "#...........########...................#",
      "#......................................#",
      "#......................................#",
      "#.....SSSSS.......................###..#",
      "#..####....####........................#",
      "#......................................#",
      "#.........................#####........#",
      "#......................................#",
      "########################################",
      "########################################"
    ]
  },
  "tileMapping": {
    "#": {
      "type": "wall",
      "solid": true,
      "tileIndex": 1
    },
    "S": {
      "type": "spike",
      "solid": false,
      "damage": 25,
      "tileIndex": 5
    },
    ".": {
      "type": "empty",
      "solid": false,
      "tileIndex": 0
    }
  },
  "enemies": [
    {"type": "slime", "x": 180, "y": 400, "facingRight": false},
    {"type": "slime", "x": 320, "y": 304, "facingRight": true},
    {"type": "slime", "x": 400, "y": 176, "facingRight": false},
    {"type": "archer", "x": 520, "y": 160, "facingRight": false},
    {"type": "bat", "x": 280, "y": 100, "facingRight": true},
    {"type": "slime", "x": 100, "y": 368, "facingRight": true}
  ],
  "pickups": [
    {"type": "health", "x": 560, "y": 368}
  ],
  "triggers": [],
  "decorations": [
    {"sprite": "torch", "x": 64, "y": 384, "animation": "burn"},
    {"sprite": "torch", "x": 576, "y": 384, "animation": "burn"},
    {"sprite": "skull", "x": 300, "y": 448, "animation": "idle"}
  ]
}
